ID,Year,Month,Day,num_of_shootings,cum_sum
0,2012,1,1,10,10
1,2012,1,2,6,16
2,2012,1,3,4,20
3,2012,1,4,3,23
4,2012,1,5,15,38
5,2012,1,6,6,44
6,2012,1,7,6,50
7,2012,1,8,6,56
8,2012,1,9,9,65
9,2012,1,10,8,73
10,2012,1,11,7,80
11,2012,1,12,3,83
12,2012,1,13,5,88
13,2012,1,14,3,91
14,2012,1,15,2,93
15,2012,1,16,3,96
16,2012,1,17,8,104
17,2012,1,19,2,106
18,2012,1,20,5,111
19,2012,1,21,4,115
20,2012,1,22,8,123
21,2012,1,23,9,132
22,2012,1,24,5,137
23,2012,1,25,2,139
24,2012,1,26,2,141
25,2012,1,27,10,151
26,2012,1,28,9,160
27,2012,1,29,2,162
28,2012,1,30,6,168
29,2012,1,31,7,175
30,2012,2,1,2,177
31,2012,2,2,5,182
32,2012,2,3,1,183
33,2012,2,4,2,185
34,2012,2,5,4,189
35,2012,2,7,3,192
36,2012,2,8,3,195
37,2012,2,9,5,200
38,2012,2,11,2,202
39,2012,2,12,5,207
40,2012,2,16,3,210
41,2012,2,17,1,211
42,2012,2,18,5,216
43,2012,2,19,22,238
44,2012,2,20,4,242
45,2012,2,21,3,245
46,2012,2,23,1,246
47,2012,2,24,7,253
48,2012,2,25,3,256
49,2012,2,26,4,260
50,2012,2,27,7,267
51,2012,2,28,2,269
52,2012,2,29,10,279
53,2012,3,1,6,285
54,2012,3,2,8,293
55,2012,3,3,4,297
56,2012,3,4,10,307
57,2012,3,5,2,309
58,2012,3,6,11,320
59,2012,3,7,9,329
60,2012,3,8,2,331
61,2012,3,9,7,338
62,2012,3,10,10,348
63,2012,3,11,13,361
64,2012,3,12,8,369
65,2012,3,13,10,379
66,2012,3,14,17,396
67,2012,3,15,9,405
68,2012,3,16,7,412
69,2012,3,17,23,435
70,2012,3,18,19,454
71,2012,3,19,10,464
72,2012,3,20,9,473
73,2012,3,21,11,484
74,2012,3,22,4,488
75,2012,3,23,5,493
76,2012,3,24,6,499
77,2012,3,25,10,509
78,2012,3,26,2,511
79,2012,3,27,10,521
80,2012,3,28,1,522
81,2012,3,29,16,538
82,2012,3,30,3,541
83,2012,3,31,5,546
84,2012,4,1,8,554
85,2012,4,2,1,555
86,2012,4,4,1,556
87,2012,4,5,6,562
88,2012,4,6,4,566
89,2012,4,7,17,583
90,2012,4,8,11,594
91,2012,4,9,6,600
92,2012,4,10,2,602
93,2012,4,11,3,605
94,2012,4,12,12,617
95,2012,4,13,6,623
96,2012,4,14,14,637
97,2012,4,15,5,642
98,2012,4,16,3,645
99,2012,4,17,3,648
100,2012,4,18,4,652
101,2012,4,19,4,656
102,2012,4,20,5,661
103,2012,4,21,7,668
104,2012,4,22,4,672
105,2012,4,23,1,673
106,2012,4,24,5,678
107,2012,4,25,3,681
108,2012,4,26,3,684
109,2012,4,27,7,691
110,2012,4,28,9,700
111,2012,4,29,3,703
112,2012,4,30,5,708
113,2012,5,1,1,709
114,2012,5,2,2,711
115,2012,5,3,11,722
116,2012,5,4,6,728
117,2012,5,5,9,737
118,2012,5,6,8,745
119,2012,5,7,3,748
120,2012,5,8,6,754
121,2012,5,9,4,758
122,2012,5,10,5,763
123,2012,5,11,14,777
124,2012,5,12,13,790
125,2012,5,13,1,791
126,2012,5,14,2,793
127,2012,5,15,2,795
128,2012,5,16,1,796
129,2012,5,17,8,804
130,2012,5,18,8,812
131,2012,5,19,9,821
132,2012,5,20,8,829
133,2012,5,21,8,837
134,2012,5,22,3,840
135,2012,5,23,4,844
136,2012,5,24,5,849
137,2012,5,25,9,858
138,2012,5,26,12,870
139,2012,5,27,18,888
140,2012,5,28,17,905
141,2012,5,29,1,906
142,2012,5,31,5,911
143,2012,6,1,6,917
144,2012,6,2,17,934
145,2012,6,3,13,947
146,2012,6,4,6,953
147,2012,6,5,10,963
148,2012,6,6,6,969
149,2012,6,7,6,975
150,2012,6,8,13,988
151,2012,6,9,21,1009
152,2012,6,10,28,1037
153,2012,6,11,9,1046
154,2012,6,12,7,1053
155,2012,6,13,11,1064
156,2012,6,14,8,1072
157,2012,6,15,6,1078
158,2012,6,16,19,1097
159,2012,6,17,19,1116
160,2012,6,18,7,1123
161,2012,6,19,2,1125
162,2012,6,20,5,1130
163,2012,6,21,5,1135
164,2012,6,22,8,1143
165,2012,6,23,17,1160
166,2012,6,24,9,1169
167,2012,6,25,2,1171
168,2012,6,26,2,1173
169,2012,6,27,5,1178
170,2012,6,28,7,1185
171,2012,6,29,4,1189
172,2012,6,30,6,1195
173,2012,7,1,17,1212
174,2012,7,2,17,1229
175,2012,7,3,18,1247
176,2012,7,4,13,1260
177,2012,7,5,28,1288
178,2012,7,6,11,1299
179,2012,7,7,8,1307
180,2012,7,8,7,1314
181,2012,7,9,9,1323
182,2012,7,10,11,1334
183,2012,7,11,9,1343
184,2012,7,12,1,1344
185,2012,7,13,5,1349
186,2012,7,14,12,1361
187,2012,7,15,5,1366
188,2012,7,16,4,1370
189,2012,7,17,4,1374
190,2012,7,18,6,1380
191,2012,7,19,5,1385
192,2012,7,20,5,1390
193,2012,7,21,23,1413
194,2012,7,22,4,1417
195,2012,7,23,18,1435
196,2012,7,24,3,1438
197,2012,7,25,7,1445
198,2012,7,26,5,1450
199,2012,7,27,1,1451
200,2012,7,28,8,1459
201,2012,7,29,6,1465
202,2012,7,30,5,1470
203,2012,7,31,7,1477
204,2012,8,1,7,1484
205,2012,8,2,18,1502
206,2012,8,3,4,1506
207,2012,8,4,12,1518
208,2012,8,5,12,1530
209,2012,8,6,9,1539
210,2012,8,7,1,1540
211,2012,8,8,8,1548
212,2012,8,9,8,1556
213,2012,8,10,3,1559
214,2012,8,11,11,1570
215,2012,8,12,8,1578
216,2012,8,13,3,1581
217,2012,8,14,3,1584
218,2012,8,15,14,1598
219,2012,8,16,3,1601
220,2012,8,17,9,1610
221,2012,8,18,20,1630
222,2012,8,19,9,1639
223,2012,8,20,7,1646
224,2012,8,21,6,1652
225,2012,8,22,5,1657
226,2012,8,23,21,1678
227,2012,8,24,13,1691
228,2012,8,25,19,1710
229,2012,8,26,15,1725
230,2012,8,27,9,1734
231,2012,8,28,4,1738
232,2012,8,29,8,1746
233,2012,8,30,10,1756
234,2012,8,31,14,1770
235,2012,9,1,8,1778
236,2012,9,2,13,1791
237,2012,9,3,14,1805
238,2012,9,4,14,1819
239,2012,9,5,5,1824
240,2012,9,6,5,1829
241,2012,9,7,5,1834
242,2012,9,8,10,1844
243,2012,9,10,2,1846
244,2012,9,11,4,1850
245,2012,9,12,6,1856
246,2012,9,13,6,1862
247,2012,9,14,3,1865
248,2012,9,15,4,1869
249,2012,9,16,2,1871
250,2012,9,17,12,1883
251,2012,9,18,2,1885
252,2012,9,19,3,1888
253,2012,9,20,6,1894
254,2012,9,21,2,1896
255,2012,9,22,12,1908
256,2012,9,23,2,1910
257,2012,9,24,1,1911
258,2012,9,25,9,1920
259,2012,9,26,2,1922
260,2012,9,27,5,1927
261,2012,9,28,10,1937
262,2012,9,29,8,1945
263,2012,9,30,3,1948
264,2012,10,1,6,1954
265,2012,10,2,3,1957
266,2012,10,3,2,1959
267,2012,10,4,3,1962
268,2012,10,5,1,1963
269,2012,10,6,9,1972
270,2012,10,7,8,1980
271,2012,10,8,3,1983
272,2012,10,9,4,1987
273,2012,10,10,6,1993
274,2012,10,11,6,1999
275,2012,10,12,4,2003
276,2012,10,13,14,2017
277,2012,10,14,15,2032
278,2012,10,15,6,2038
279,2012,10,16,7,2045
280,2012,10,17,4,2049
281,2012,10,19,7,2056
282,2012,10,20,4,2060
283,2012,10,21,16,2076
284,2012,10,22,7,2083
285,2012,10,23,4,2087
286,2012,10,24,4,2091
287,2012,10,25,5,2096
288,2012,10,26,2,2098
289,2012,10,27,6,2104
290,2012,10,28,13,2117
291,2012,10,29,12,2129
292,2012,10,30,6,2135
293,2012,10,31,5,2140
294,2012,11,1,5,2145
295,2012,11,3,9,2154
296,2012,11,4,6,2160
297,2012,11,5,2,2162
298,2012,11,6,8,2170
299,2012,11,7,4,2174
300,2012,11,8,5,2179
301,2012,11,9,7,2186
302,2012,11,10,8,2194
303,2012,11,11,15,2209
304,2012,11,12,5,2214
305,2012,11,13,3,2217
306,2012,11,14,4,2221
307,2012,11,15,8,2229
308,2012,11,16,3,2232
309,2012,11,17,12,2244
310,2012,11,18,12,2256
311,2012,11,19,8,2264
312,2012,11,20,7,2271
313,2012,11,21,7,2278
314,2012,11,22,4,2282
315,2012,11,23,6,2288
316,2012,11,24,4,2292
317,2012,11,25,9,2301
318,2012,11,26,7,2308
319,2012,11,27,6,2314
320,2012,11,28,3,2317
321,2012,11,29,6,2323
322,2012,11,30,14,2337
323,2012,12,1,19,2356
324,2012,12,2,8,2364
325,2012,12,3,11,2375
326,2012,12,4,7,2382
327,2012,12,5,10,2392
328,2012,12,6,4,2396
329,2012,12,7,2,2398
330,2012,12,8,8,2406
331,2012,12,9,7,2413
332,2012,12,10,5,2418
333,2012,12,11,6,2424
334,2012,12,12,1,2425
335,2012,12,13,3,2428
336,2012,12,14,11,2439
337,2012,12,15,1,2440
338,2012,12,16,7,2447
339,2012,12,17,4,2451
340,2012,12,18,5,2456
341,2012,12,19,5,2461
342,2012,12,20,5,2466
343,2012,12,21,3,2469
344,2012,12,22,5,2474
345,2012,12,23,7,2481
346,2012,12,24,8,2489
347,2012,12,25,6,2495
348,2012,12,26,3,2498
349,2012,12,27,7,2505
350,2012,12,28,4,2509
351,2012,12,30,7,2516
352,2012,12,31,2,2518
353,2013,1,1,16,16
354,2013,1,2,4,20
355,2013,1,3,9,29
356,2013,1,4,6,35
357,2013,1,5,12,47
358,2013,1,6,7,54
359,2013,1,7,6,60
360,2013,1,8,9,69
361,2013,1,9,5,74
362,2013,1,10,4,78
363,2013,1,11,12,90
364,2013,1,12,1,91
365,2013,1,13,3,94
366,2013,1,14,3,97
367,2013,1,15,5,102
368,2013,1,16,5,107
369,2013,1,17,5,112
370,2013,1,18,10,122
371,2013,1,19,5,127
372,2013,1,20,7,134
373,2013,1,21,1,135
374,2013,1,22,2,137
375,2013,1,23,6,143
376,2013,1,24,1,144
377,2013,1,25,3,147
378,2013,1,26,11,158
379,2013,1,27,2,160
380,2013,1,28,10,170
381,2013,1,29,13,183
382,2013,1,30,4,187
383,2013,1,31,3,190
384,2013,2,1,5,195
385,2013,2,2,3,198
386,2013,2,3,4,202
387,2013,2,4,2,204
388,2013,2,5,3,207
389,2013,2,6,2,209
390,2013,2,7,6,215
391,2013,2,8,4,219
392,2013,2,9,3,222
393,2013,2,10,3,225
394,2013,2,11,2,227
395,2013,2,12,2,229
396,2013,2,13,4,233
397,2013,2,14,2,235
398,2013,2,15,5,240
399,2013,2,16,5,245
400,2013,2,17,3,248
401,2013,2,18,3,251
402,2013,2,19,3,254
403,2013,2,20,2,256
404,2013,2,21,2,258
405,2013,2,22,4,262
406,2013,2,23,6,268
407,2013,2,24,5,273
408,2013,2,25,1,274
409,2013,2,26,3,277
410,2013,2,27,3,280
411,2013,2,28,1,281
412,2013,3,1,2,283
413,2013,3,2,1,284
414,2013,3,3,7,291
415,2013,3,4,3,294
416,2013,3,6,1,295
417,2013,3,7,2,297
418,2013,3,8,3,300
419,2013,3,9,2,302
420,2013,3,10,4,306
421,2013,3,11,3,309
422,2013,3,12,3,312
423,2013,3,13,1,313
424,2013,3,14,4,317
425,2013,3,15,2,319
426,2013,3,16,6,325
427,2013,3,17,7,332
428,2013,3,18,1,333
429,2013,3,19,3,336
430,2013,3,20,2,338
431,2013,3,21,11,349
432,2013,3,22,4,353
433,2013,3,23,6,359
434,2013,3,24,4,363
435,2013,3,25,5,368
436,2013,3,26,3,371
437,2013,3,27,3,374
438,2013,3,28,5,379
439,2013,3,29,11,390
440,2013,3,30,6,396
441,2013,3,31,14,410
442,2013,4,1,4,414
443,2013,4,3,4,418
444,2013,4,4,7,425
445,2013,4,5,1,426
446,2013,4,6,8,434
447,2013,4,7,4,438
448,2013,4,8,8,446
449,2013,4,9,2,448
450,2013,4,10,3,451
451,2013,4,11,3,454
452,2013,4,12,5,459
453,2013,4,13,9,468
454,2013,4,14,14,482
455,2013,4,15,3,485
456,2013,4,16,3,488
457,2013,4,17,2,490
458,2013,4,18,7,497
459,2013,4,19,6,503
460,2013,4,20,6,509
461,2013,4,21,4,513
462,2013,4,22,9,522
463,2013,4,23,5,527
464,2013,4,24,7,534
465,2013,4,25,1,535
466,2013,4,26,5,540
467,2013,4,27,6,546
468,2013,4,28,10,556
469,2013,4,29,3,559
470,2013,4,30,21,580
471,2013,5,1,4,584
472,2013,5,2,3,587
473,2013,5,3,1,588
474,2013,5,4,2,590
475,2013,5,5,5,595
476,2013,5,6,6,601
477,2013,5,7,4,605
478,2013,5,8,9,614
479,2013,5,9,2,616
480,2013,5,10,2,618
481,2013,5,11,6,624
482,2013,5,12,6,630
483,2013,5,13,8,638
484,2013,5,14,7,645
485,2013,5,15,15,660
486,2013,5,16,3,663
487,2013,5,17,11,674
488,2013,5,18,8,682
489,2013,5,19,7,689
490,2013,5,20,10,699
491,2013,5,21,4,703
492,2013,5,22,3,706
493,2013,5,23,1,707
494,2013,5,24,9,716
495,2013,5,25,8,724
496,2013,5,26,6,730
497,2013,5,27,7,737
498,2013,5,28,2,739
499,2013,5,29,13,752
500,2013,5,30,9,761
501,2013,5,31,5,766
502,2013,6,1,7,773
503,2013,6,2,5,778
504,2013,6,3,8,786
505,2013,6,4,4,790
506,2013,6,5,12,802
507,2013,6,6,5,807
508,2013,6,7,10,817
509,2013,6,8,8,825
510,2013,6,9,6,831
511,2013,6,10,11,842
512,2013,6,11,10,852
513,2013,6,12,9,861
514,2013,6,13,9,870
515,2013,6,14,10,880
516,2013,6,15,18,898
517,2013,6,16,22,920
518,2013,6,17,13,933
519,2013,6,19,11,944
520,2013,6,20,6,950
521,2013,6,21,14,964
522,2013,6,22,8,972
523,2013,6,23,16,988
524,2013,6,24,5,993
525,2013,6,25,5,998
526,2013,6,26,4,1002
527,2013,6,27,5,1007
528,2013,6,28,11,1018
529,2013,6,29,7,1025
530,2013,6,30,10,1035
531,2013,7,1,8,1043
532,2013,7,2,3,1046
533,2013,7,3,14,1060
534,2013,7,4,18,1078
535,2013,7,5,21,1099
536,2013,7,6,16,1115
537,2013,7,7,8,1123
538,2013,7,8,6,1129
539,2013,7,9,2,1131
540,2013,7,10,6,1137
541,2013,7,11,4,1141
542,2013,7,12,5,1146
543,2013,7,13,5,1151
544,2013,7,14,10,1161
545,2013,7,15,4,1165
546,2013,7,16,7,1172
547,2013,7,17,7,1179
548,2013,7,18,9,1188
549,2013,7,19,10,1198
550,2013,7,20,10,1208
551,2013,7,21,12,1220
552,2013,7,22,6,1226
553,2013,7,23,3,1229
554,2013,7,24,5,1234
555,2013,7,25,7,1241
556,2013,7,26,6,1247
557,2013,7,27,10,1257
558,2013,7,28,5,1262
559,2013,7,29,9,1271
560,2013,7,30,7,1278
561,2013,7,31,7,1285
562,2013,8,1,4,1289
563,2013,8,2,9,1298
564,2013,8,3,9,1307
565,2013,8,4,9,1316
566,2013,8,5,11,1327
567,2013,8,6,6,1333
568,2013,8,7,8,1341
569,2013,8,8,8,1349
570,2013,8,9,4,1353
571,2013,8,10,17,1370
572,2013,8,11,15,1385
573,2013,8,12,9,1394
574,2013,8,13,7,1401
575,2013,8,14,7,1408
576,2013,8,15,13,1421
577,2013,8,16,13,1434
578,2013,8,17,12,1446
579,2013,8,18,19,1465
580,2013,8,19,10,1475
581,2013,8,20,8,1483
582,2013,8,21,8,1491
583,2013,8,22,2,1493
584,2013,8,23,1,1494
585,2013,8,24,6,1500
586,2013,8,25,13,1513
587,2013,8,26,3,1516
588,2013,8,27,4,1520
589,2013,8,28,4,1524
590,2013,8,29,7,1531
591,2013,8,30,2,1533
592,2013,8,31,9,1542
593,2013,9,1,9,1551
594,2013,9,2,17,1568
595,2013,9,3,6,1574
596,2013,9,4,8,1582
597,2013,9,5,4,1586
598,2013,9,6,5,1591
599,2013,9,7,7,1598
600,2013,9,8,9,1607
601,2013,9,9,10,1617
602,2013,9,10,7,1624
603,2013,9,11,8,1632
604,2013,9,12,8,1640
605,2013,9,13,5,1645
606,2013,9,14,5,1650
607,2013,9,15,8,1658
608,2013,9,16,2,1660
609,2013,9,17,2,1662
610,2013,9,18,2,1664
611,2013,9,19,20,1684
612,2013,9,20,9,1693
613,2013,9,21,11,1704
614,2013,9,22,10,1714
615,2013,9,23,4,1718
616,2013,9,24,5,1723
617,2013,9,25,4,1727
618,2013,9,26,5,1732
619,2013,9,27,11,1743
620,2013,9,28,6,1749
621,2013,9,29,5,1754
622,2013,9,30,4,1758
623,2013,10,1,4,1762
624,2013,10,2,5,1767
625,2013,10,3,8,1775
626,2013,10,4,10,1785
627,2013,10,5,7,1792
628,2013,10,7,8,1800
629,2013,10,8,5,1805
630,2013,10,9,12,1817
631,2013,10,10,3,1820
632,2013,10,11,3,1823
633,2013,10,12,3,1826
634,2013,10,13,4,1830
635,2013,10,14,6,1836
636,2013,10,15,3,1839
637,2013,10,16,4,1843
638,2013,10,17,4,1847
639,2013,10,18,4,1851
640,2013,10,19,3,1854
641,2013,10,20,5,1859
642,2013,10,21,2,1861
643,2013,10,22,3,1864
644,2013,10,24,2,1866
645,2013,10,25,2,1868
646,2013,10,26,10,1878
647,2013,10,27,4,1882
648,2013,10,28,5,1887
649,2013,10,29,5,1892
650,2013,10,30,1,1893
651,2013,10,31,6,1899
652,2013,11,1,7,1906
653,2013,11,2,5,1911
654,2013,11,3,7,1918
655,2013,11,4,4,1922
656,2013,11,5,1,1923
657,2013,11,6,12,1935
658,2013,11,7,1,1936
659,2013,11,8,3,1939
660,2013,11,9,9,1948
661,2013,11,10,2,1950
662,2013,11,11,3,1953
663,2013,11,12,6,1959
664,2013,11,13,3,1962
665,2013,11,14,6,1968
666,2013,11,15,2,1970
667,2013,11,16,7,1977
668,2013,11,17,12,1989
669,2013,11,18,3,1992
670,2013,11,19,7,1999
671,2013,11,20,1,2000
672,2013,11,21,2,2002
673,2013,11,22,3,2005
674,2013,11,23,10,2015
675,2013,11,24,2,2017
676,2013,11,25,5,2022
677,2013,11,26,3,2025
678,2013,11,27,2,2027
679,2013,11,28,3,2030
680,2013,11,29,1,2031
681,2013,11,30,3,2034
682,2013,12,1,4,2038
683,2013,12,2,8,2046
684,2013,12,3,7,2053
685,2013,12,4,1,2054
686,2013,12,5,5,2059
687,2013,12,6,1,2060
688,2013,12,7,6,2066
689,2013,12,8,9,2075
690,2013,12,9,2,2077
691,2013,12,10,5,2082
692,2013,12,11,1,2083
693,2013,12,12,2,2085
694,2013,12,13,5,2090
695,2013,12,14,7,2097
696,2013,12,15,9,2106
697,2013,12,16,1,2107
698,2013,12,17,2,2109
699,2013,12,18,2,2111
700,2013,12,19,10,2121
701,2013,12,20,5,2126
702,2013,12,21,6,2132
703,2013,12,22,6,2138
704,2013,12,23,8,2146
705,2013,12,24,5,2151
706,2013,12,25,3,2154
707,2013,12,26,4,2158
708,2013,12,27,5,2163
709,2013,12,28,7,2170
710,2013,12,29,7,2177
711,2013,12,30,7,2184
712,2013,12,31,2,2186
713,2014,1,1,2,2
714,2014,1,3,4,6
715,2014,1,4,8,14
716,2014,1,5,1,15
717,2014,1,7,1,16
718,2014,1,8,6,22
719,2014,1,9,1,23
720,2014,1,11,5,28
721,2014,1,12,2,30
722,2014,1,13,3,33
723,2014,1,14,1,34
724,2014,1,15,5,39
725,2014,1,16,3,42
726,2014,1,17,3,45
727,2014,1,18,9,54
728,2014,1,19,3,57
729,2014,1,20,2,59
730,2014,1,22,5,64
731,2014,1,24,1,65
732,2014,1,25,9,74
733,2014,1,26,6,80
734,2014,1,27,2,82
735,2014,1,28,10,92
736,2014,1,29,3,95
737,2014,1,30,3,98
738,2014,1,31,3,101
739,2014,2,1,7,108
740,2014,2,2,3,111
741,2014,2,3,1,112
742,2014,2,4,2,114
743,2014,2,5,6,120
744,2014,2,6,3,123
745,2014,2,7,1,124
746,2014,2,8,1,125
747,2014,2,9,9,134
748,2014,2,10,1,135
749,2014,2,12,2,137
750,2014,2,13,1,138
751,2014,2,14,1,139
752,2014,2,15,1,140
753,2014,2,18,4,144
754,2014,2,19,3,147
755,2014,2,20,3,150
756,2014,2,21,2,152
757,2014,2,22,9,161
758,2014,2,23,1,162
759,2014,2,24,3,165
760,2014,2,25,2,167
761,2014,2,27,4,171
762,2014,2,28,3,174
763,2014,3,1,7,181
764,2014,3,2,2,183
765,2014,3,3,2,185
766,2014,3,4,1,186
767,2014,3,5,5,191
768,2014,3,6,4,195
769,2014,3,7,3,198
770,2014,3,8,2,200
771,2014,3,9,9,209
772,2014,3,10,6,215
773,2014,3,11,7,222
774,2014,3,12,3,225
775,2014,3,14,1,226
776,2014,3,15,5,231
777,2014,3,16,3,234
778,2014,3,17,3,237
779,2014,3,18,3,240
780,2014,3,19,3,243
781,2014,3,20,4,247
782,2014,3,21,9,256
783,2014,3,22,4,260
784,2014,3,23,10,270
785,2014,3,24,2,272
786,2014,3,25,3,275
787,2014,3,27,2,277
788,2014,3,28,7,284
789,2014,3,29,8,292
790,2014,3,30,5,297
791,2014,3,31,6,303
792,2014,4,1,8,311
793,2014,4,2,2,313
794,2014,4,3,2,315
795,2014,4,4,6,321
796,2014,4,5,15,336
797,2014,4,6,5,341
798,2014,4,7,10,351
799,2014,4,8,4,355
800,2014,4,9,12,367
801,2014,4,10,7,374
802,2014,4,11,11,385
803,2014,4,12,19,404
804,2014,4,13,11,415
805,2014,4,14,4,419
806,2014,4,15,4,423
807,2014,4,16,3,426
808,2014,4,17,4,430
809,2014,4,18,11,441
810,2014,4,19,18,459
811,2014,4,20,20,479
812,2014,4,21,4,483
813,2014,4,22,8,491
814,2014,4,23,3,494
815,2014,4,24,10,504
816,2014,4,25,16,520
817,2014,4,26,20,540
818,2014,4,27,9,549
819,2014,4,28,7,556
820,2014,4,29,6,562
821,2014,4,30,13,575
822,2014,5,1,5,580
823,2014,5,2,4,584
824,2014,5,3,16,600
825,2014,5,4,10,610
826,2014,5,5,8,618
827,2014,5,6,7,625
828,2014,5,7,4,629
829,2014,5,8,11,640
830,2014,5,9,8,648
831,2014,5,10,10,658
832,2014,5,11,12,670
833,2014,5,12,10,680
834,2014,5,13,7,687
835,2014,5,14,3,690
836,2014,5,15,5,695
837,2014,5,16,4,699
838,2014,5,17,16,715
839,2014,5,18,12,727
840,2014,5,19,4,731
841,2014,5,20,10,741
842,2014,5,21,15,756
843,2014,5,22,7,763
844,2014,5,24,9,772
845,2014,5,25,7,779
846,2014,5,26,16,795
847,2014,5,27,14,809
848,2014,5,28,9,818
849,2014,5,29,16,834
850,2014,5,30,6,840
851,2014,5,31,10,850
852,2014,6,1,20,870
853,2014,6,2,15,885
854,2014,6,3,5,890
855,2014,6,4,11,901
856,2014,6,5,7,908
857,2014,6,6,14,922
858,2014,6,7,12,934
859,2014,6,8,5,939
860,2014,6,9,10,949
861,2014,6,10,5,954
862,2014,6,11,6,960
863,2014,6,12,8,968
864,2014,6,13,12,980
865,2014,6,14,8,988
866,2014,6,15,15,1003
867,2014,6,16,4,1007
868,2014,6,17,11,1018
869,2014,6,18,1,1019
870,2014,6,19,9,1028
871,2014,6,20,3,1031
872,2014,6,21,14,1045
873,2014,6,22,12,1057
874,2014,6,23,5,1062
875,2014,6,24,6,1068
876,2014,6,25,6,1074
877,2014,6,26,8,1082
878,2014,6,27,12,1094
879,2014,6,28,11,1105
880,2014,6,29,15,1120
881,2014,6,30,13,1133
882,2014,7,1,5,1138
883,2014,7,2,9,1147
884,2014,7,3,8,1155
885,2014,7,4,19,1174
886,2014,7,5,17,1191
887,2014,7,6,29,1220
888,2014,7,7,20,1240
889,2014,7,8,9,1249
890,2014,7,9,9,1258
891,2014,7,10,3,1261
892,2014,7,11,16,1277
893,2014,7,12,8,1285
894,2014,7,13,8,1293
895,2014,7,14,8,1301
896,2014,7,15,5,1306
897,2014,7,16,8,1314
898,2014,7,17,7,1321
899,2014,7,18,20,1341
900,2014,7,19,12,1353
901,2014,7,20,16,1369
902,2014,7,21,8,1377
903,2014,7,22,7,1384
904,2014,7,23,6,1390
905,2014,7,24,7,1397
906,2014,7,25,11,1408
907,2014,7,26,9,1417
908,2014,7,27,8,1425
909,2014,7,28,6,1431
910,2014,7,29,6,1437
911,2014,7,30,8,1445
912,2014,7,31,6,1451
913,2014,8,1,13,1464
914,2014,8,2,7,1471
915,2014,8,3,8,1479
916,2014,8,4,9,1488
917,2014,8,5,3,1491
918,2014,8,6,10,1501
919,2014,8,7,4,1505
920,2014,8,8,3,1508
921,2014,8,9,8,1516
922,2014,8,10,16,1532
923,2014,8,11,8,1540
924,2014,8,12,4,1544
925,2014,8,13,7,1551
926,2014,8,14,9,1560
927,2014,8,15,8,1568
928,2014,8,16,14,1582
929,2014,8,17,14,1596
930,2014,8,18,8,1604
931,2014,8,19,6,1610
932,2014,8,20,8,1618
933,2014,8,21,6,1624
934,2014,8,22,5,1629
935,2014,8,23,11,1640
936,2014,8,24,26,1666
937,2014,8,25,15,1681
938,2014,8,26,5,1686
939,2014,8,27,5,1691
940,2014,8,28,4,1695
941,2014,8,29,7,1702
942,2014,8,30,8,1710
943,2014,8,31,19,1729
944,2014,9,1,6,1735
945,2014,9,2,2,1737
946,2014,9,3,4,1741
947,2014,9,4,2,1743
948,2014,9,5,6,1749
949,2014,9,6,14,1763
950,2014,9,7,9,1772
951,2014,9,8,5,1777
952,2014,9,9,2,1779
953,2014,9,10,6,1785
954,2014,9,11,7,1792
955,2014,9,12,3,1795
956,2014,9,13,7,1802
957,2014,9,14,7,1809
958,2014,9,15,3,1812
959,2014,9,16,4,1816
960,2014,9,17,9,1825
961,2014,9,18,6,1831
962,2014,9,19,13,1844
963,2014,9,20,13,1857
964,2014,9,21,8,1865
965,2014,9,22,10,1875
966,2014,9,23,4,1879
967,2014,9,24,8,1887
968,2014,9,25,8,1895
969,2014,9,26,11,1906
970,2014,9,27,20,1926
971,2014,9,28,15,1941
972,2014,9,29,9,1950
973,2014,9,30,8,1958
974,2014,10,1,7,1965
975,2014,10,2,6,1971
976,2014,10,3,7,1978
977,2014,10,4,13,1991
978,2014,10,5,14,2005
979,2014,10,6,4,2009
980,2014,10,7,13,2022
981,2014,10,8,8,2030
982,2014,10,9,3,2033
983,2014,10,10,7,2040
984,2014,10,11,8,2048
985,2014,10,12,8,2056
986,2014,10,13,3,2059
987,2014,10,14,2,2061
988,2014,10,15,7,2068
989,2014,10,16,5,2073
990,2014,10,17,6,2079
991,2014,10,18,11,2090
992,2014,10,19,7,2097
993,2014,10,20,3,2100
994,2014,10,21,5,2105
995,2014,10,22,4,2109
996,2014,10,23,8,2117
997,2014,10,24,9,2126
998,2014,10,25,12,2138
999,2014,10,26,19,2157
1000,2014,10,27,15,2172
1001,2014,10,28,2,2174
1002,2014,10,29,2,2176
1003,2014,10,30,5,2181
1004,2014,10,31,3,2184
1005,2014,11,1,5,2189
1006,2014,11,2,7,2196
1007,2014,11,3,5,2201
1008,2014,11,4,3,2204
1009,2014,11,5,4,2208
1010,2014,11,6,2,2210
1011,2014,11,7,11,2221
1012,2014,11,8,8,2229
1013,2014,11,9,3,2232
1014,2014,11,10,4,2236
1015,2014,11,11,9,2245
1016,2014,11,12,2,2247
1017,2014,11,13,3,2250
1018,2014,11,15,7,2257
1019,2014,11,16,14,2271
1020,2014,11,17,4,2275
1021,2014,11,18,3,2278
1022,2014,11,19,10,2288
1023,2014,11,20,1,2289
1024,2014,11,21,3,2292
1025,2014,11,22,12,2304
1026,2014,11,23,3,2307
1027,2014,11,24,3,2310
1028,2014,11,25,4,2314
1029,2014,11,26,6,2320
1030,2014,11,27,5,2325
1031,2014,11,28,7,2332
1032,2014,11,29,4,2336
1033,2014,11,30,3,2339
1034,2014,12,1,1,2340
1035,2014,12,2,1,2341
1036,2014,12,3,3,2344
1037,2014,12,4,3,2347
1038,2014,12,5,8,2355
1039,2014,12,6,8,2363
1040,2014,12,7,9,2372
1041,2014,12,8,9,2381
1042,2014,12,9,9,2390
1043,2014,12,10,6,2396
1044,2014,12,11,4,2400
1045,2014,12,12,13,2413
1046,2014,12,13,17,2430
1047,2014,12,14,8,2438
1048,2014,12,15,8,2446
1049,2014,12,16,7,2453
1050,2014,12,17,16,2469
1051,2014,12,18,4,2473
1052,2014,12,19,17,2490
1053,2014,12,20,7,2497
1054,2014,12,21,12,2509
1055,2014,12,22,10,2519
1056,2014,12,23,17,2536
1057,2014,12,24,6,2542
1058,2014,12,25,4,2546
1059,2014,12,26,10,2556
1060,2014,12,27,5,2561
1061,2014,12,28,13,2574
1062,2014,12,29,2,2576
1063,2014,12,30,2,2578
1064,2014,12,31,3,2581
1065,2015,1,1,9,9
1066,2015,1,2,6,15
1067,2015,1,3,7,22
1068,2015,1,4,4,26
1069,2015,1,5,3,29
1070,2015,1,6,5,34
1071,2015,1,8,3,37
1072,2015,1,9,4,41
1073,2015,1,10,1,42
1074,2015,1,11,1,43
1075,2015,1,13,5,48
1076,2015,1,14,8,56
1077,2015,1,16,4,60
1078,2015,1,17,7,67
1079,2015,1,18,7,74
1080,2015,1,19,4,78
1081,2015,1,20,2,80
1082,2015,1,21,12,92
1083,2015,1,22,3,95
1084,2015,1,23,12,107
1085,2015,1,24,10,117
1086,2015,1,25,6,123
1087,2015,1,26,3,126
1088,2015,1,27,3,129
1089,2015,1,28,4,133
1090,2015,1,29,6,139
1091,2015,1,30,4,143
1092,2015,1,31,3,146
1093,2015,2,1,2,148
1094,2015,2,3,3,151
1095,2015,2,4,3,154
1096,2015,2,6,1,155
1097,2015,2,7,5,160
1098,2015,2,8,3,163
1099,2015,2,9,2,165
1100,2015,2,10,1,166
1101,2015,2,11,2,168
1102,2015,2,12,1,169
1103,2015,2,13,1,170
1104,2015,2,14,4,174
1105,2015,2,15,2,176
1106,2015,2,16,4,180
1107,2015,2,17,2,182
1108,2015,2,19,3,185
1109,2015,2,20,6,191
1110,2015,2,21,3,194
1111,2015,2,22,7,201
1112,2015,2,23,4,205
1113,2015,2,25,11,216
1114,2015,2,26,1,217
1115,2015,2,27,1,218
1116,2015,3,1,3,221
1117,2015,3,2,3,224
1118,2015,3,3,8,232
1119,2015,3,4,2,234
1120,2015,3,5,6,240
1121,2015,3,6,4,244
1122,2015,3,7,11,255
1123,2015,3,8,7,262
1124,2015,3,9,14,276
1125,2015,3,10,6,282
1126,2015,3,11,4,286
1127,2015,3,12,4,290
1128,2015,3,13,7,297
1129,2015,3,14,6,303
1130,2015,3,15,16,319
1131,2015,3,16,14,333
1132,2015,3,17,1,334
1133,2015,3,18,12,346
1134,2015,3,19,4,350
1135,2015,3,20,3,353
1136,2015,3,21,10,363
1137,2015,3,22,10,373
1138,2015,3,23,6,379
1139,2015,3,24,6,385
1140,2015,3,25,7,392
1141,2015,3,26,4,396
1142,2015,3,27,8,404
1143,2015,3,28,9,413
1144,2015,3,29,3,416
1145,2015,3,30,9,425
1146,2015,3,31,5,430
1147,2015,4,1,11,441
1148,2015,4,2,11,452
1149,2015,4,3,10,462
1150,2015,4,4,5,467
1151,2015,4,5,8,475
1152,2015,4,6,2,477
1153,2015,4,7,2,479
1154,2015,4,8,8,487
1155,2015,4,9,2,489
1156,2015,4,10,3,492
1157,2015,4,11,8,500
1158,2015,4,12,13,513
1159,2015,4,13,12,525
1160,2015,4,14,8,533
1161,2015,4,15,10,543
1162,2015,4,16,9,552
1163,2015,4,17,16,568
1164,2015,4,18,5,573
1165,2015,4,19,15,588
1166,2015,4,20,6,594
1167,2015,4,21,6,600
1168,2015,4,22,6,606
1169,2015,4,23,6,612
1170,2015,4,24,8,620
1171,2015,4,25,5,625
1172,2015,4,26,13,638
1173,2015,4,27,8,646
1174,2015,4,28,3,649
1175,2015,4,29,12,661
1176,2015,4,30,3,664
1177,2015,5,1,10,674
1178,2015,5,2,14,688
1179,2015,5,3,13,701
1180,2015,5,4,7,708
1181,2015,5,5,3,711
1182,2015,5,6,2,713
1183,2015,5,7,9,722
1184,2015,5,8,4,726
1185,2015,5,9,9,735
1186,2015,5,10,10,745
1187,2015,5,11,14,759
1188,2015,5,12,4,763
1189,2015,5,13,13,776
1190,2015,5,14,4,780
1191,2015,5,15,13,793
1192,2015,5,16,19,812
1193,2015,5,17,13,825
1194,2015,5,18,9,834
1195,2015,5,19,8,842
1196,2015,5,20,6,848
1197,2015,5,21,14,862
1198,2015,5,22,9,871
1199,2015,5,23,17,888
1200,2015,5,24,16,904
1201,2015,5,25,15,919
1202,2015,5,26,11,930
1203,2015,5,27,6,936
1204,2015,5,28,15,951
1205,2015,5,29,6,957
1206,2015,5,30,17,974
1207,2015,5,31,8,982
1208,2015,6,1,8,990
1209,2015,6,2,7,997
1210,2015,6,3,3,1000
1211,2015,6,4,8,1008
1212,2015,6,5,8,1016
1213,2015,6,6,16,1032
1214,2015,6,7,16,1048
1215,2015,6,8,7,1055
1216,2015,6,9,8,1063
1217,2015,6,10,11,1074
1218,2015,6,11,9,1083
1219,2015,6,12,16,1099
1220,2015,6,13,8,1107
1221,2015,6,14,9,1116
1222,2015,6,15,9,1125
1223,2015,6,16,7,1132
1224,2015,6,17,8,1140
1225,2015,6,18,20,1160
1226,2015,6,19,5,1165
1227,2015,6,20,15,1180
1228,2015,6,21,19,1199
1229,2015,6,22,6,1205
1230,2015,6,23,18,1223
1231,2015,6,24,8,1231
1232,2015,6,25,8,1239
1233,2015,6,26,6,1245
1234,2015,6,27,11,1256
1235,2015,6,28,12,1268
1236,2015,6,29,7,1275
1237,2015,6,30,7,1282
1238,2015,7,1,8,1290
1239,2015,7,2,7,1297
1240,2015,7,3,9,1306
1241,2015,7,4,12,1318
1242,2015,7,5,34,1352
1243,2015,7,6,15,1367
1244,2015,7,7,9,1376
1245,2015,7,8,6,1382
1246,2015,7,9,6,1388
1247,2015,7,10,11,1399
1248,2015,7,11,14,1413
1249,2015,7,12,11,1424
1250,2015,7,13,3,1427
1251,2015,7,14,13,1440
1252,2015,7,15,9,1449
1253,2015,7,16,2,1451
1254,2015,7,17,14,1465
1255,2015,7,18,11,1476
1256,2015,7,19,13,1489
1257,2015,7,20,10,1499
1258,2015,7,21,6,1505
1259,2015,7,22,6,1511
1260,2015,7,23,4,1515
1261,2015,7,24,6,1521
1262,2015,7,25,16,1537
1263,2015,7,26,16,1553
1264,2015,7,27,13,1566
1265,2015,7,28,7,1573
1266,2015,7,29,9,1582
1267,2015,7,30,14,1596
1268,2015,7,31,9,1605
1269,2015,8,1,15,1620
1270,2015,8,2,23,1643
1271,2015,8,3,6,1649
1272,2015,8,4,6,1655
1273,2015,8,5,10,1665
1274,2015,8,6,10,1675
1275,2015,8,7,20,1695
1276,2015,8,8,20,1715
1277,2015,8,9,10,1725
1278,2015,8,10,8,1733
1279,2015,8,11,6,1739
1280,2015,8,12,13,1752
1281,2015,8,13,7,1759
1282,2015,8,14,13,1772
1283,2015,8,15,10,1782
1284,2015,8,16,19,1801
1285,2015,8,17,16,1817
1286,2015,8,18,5,1822
1287,2015,8,19,6,1828
1288,2015,8,20,13,1841
1289,2015,8,21,13,1854
1290,2015,8,22,18,1872
1291,2015,8,23,15,1887
1292,2015,8,24,11,1898
1293,2015,8,25,12,1910
1294,2015,8,26,10,1920
1295,2015,8,27,8,1928
1296,2015,8,28,7,1935
1297,2015,8,29,13,1948
1298,2015,8,30,15,1963
1299,2015,8,31,8,1971
1300,2015,9,1,13,1984
1301,2015,9,2,20,2004
1302,2015,9,3,11,2015
1303,2015,9,4,16,2031
1304,2015,9,5,11,2042
1305,2015,9,6,13,2055
1306,2015,9,7,14,2069
1307,2015,9,8,9,2078
1308,2015,9,9,3,2081
1309,2015,9,10,8,2089
1310,2015,9,11,2,2091
1311,2015,9,12,8,2099
1312,2015,9,13,20,2119
1313,2015,9,14,10,2129
1314,2015,9,15,15,2144
1315,2015,9,16,8,2152
1316,2015,9,17,9,2161
1317,2015,9,18,15,2176
1318,2015,9,19,17,2193
1319,2015,9,20,26,2219
1320,2015,9,21,5,2224
1321,2015,9,22,4,2228
1322,2015,9,23,10,2238
1323,2015,9,24,13,2251
1324,2015,9,25,11,2262
1325,2015,9,26,18,2280
1326,2015,9,27,28,2308
1327,2015,9,28,11,2319
1328,2015,9,29,10,2329
1329,2015,9,30,6,2335
1330,2015,10,1,3,2338
1331,2015,10,2,3,2341
1332,2015,10,3,5,2346
1333,2015,10,4,7,2353
1334,2015,10,5,4,2357
1335,2015,10,6,9,2366
1336,2015,10,7,5,2371
1337,2015,10,8,8,2379
1338,2015,10,9,6,2385
1339,2015,10,10,6,2391
1340,2015,10,11,12,2403
1341,2015,10,12,8,2411
1342,2015,10,13,12,2423
1343,2015,10,14,4,2427
1344,2015,10,15,8,2435
1345,2015,10,16,6,2441
1346,2015,10,17,13,2454
1347,2015,10,18,8,2462
1348,2015,10,19,6,2468
1349,2015,10,20,5,2473
1350,2015,10,21,8,2481
1351,2015,10,22,4,2485
1352,2015,10,23,10,2495
1353,2015,10,24,13,2508
1354,2015,10,25,14,2522
1355,2015,10,26,5,2527
1356,2015,10,27,4,2531
1357,2015,10,28,4,2535
1358,2015,10,29,8,2543
1359,2015,10,30,13,2556
1360,2015,10,31,12,2568
1361,2015,11,1,10,2578
1362,2015,11,2,9,2587
1363,2015,11,3,12,2599
1364,2015,11,4,2,2601
1365,2015,11,5,8,2609
1366,2015,11,6,11,2620
1367,2015,11,7,9,2629
1368,2015,11,8,4,2633
1369,2015,11,9,3,2636
1370,2015,11,10,9,2645
1371,2015,11,11,4,2649
1372,2015,11,12,6,2655
1373,2015,11,13,5,2660
1374,2015,11,14,8,2668
1375,2015,11,15,6,2674
1376,2015,11,16,5,2679
1377,2015,11,17,6,2685
1378,2015,11,18,3,2688
1379,2015,11,19,4,2692
1380,2015,11,20,4,2696
1381,2015,11,21,4,2700
1382,2015,11,22,1,2701
1383,2015,11,23,7,2708
1384,2015,11,24,5,2713
1385,2015,11,25,7,2720
1386,2015,11,26,4,2724
1387,2015,11,27,5,2729
1388,2015,11,28,4,2733
1389,2015,11,29,11,2744
1390,2015,11,30,5,2749
1391,2015,12,1,11,2760
1392,2015,12,2,4,2764
1393,2015,12,3,6,2770
1394,2015,12,4,8,2778
1395,2015,12,5,8,2786
1396,2015,12,6,9,2795
1397,2015,12,7,2,2797
1398,2015,12,8,11,2808
1399,2015,12,9,3,2811
1400,2015,12,10,1,2812
1401,2015,12,11,6,2818
1402,2015,12,12,14,2832
1403,2015,12,13,11,2843
1404,2015,12,14,16,2859
1405,2015,12,15,2,2861
1406,2015,12,16,11,2872
1407,2015,12,17,9,2881
1408,2015,12,18,5,2886
1409,2015,12,19,11,2897
1410,2015,12,20,8,2905
1411,2015,12,21,4,2909
1412,2015,12,22,9,2918
1413,2015,12,23,7,2925
1414,2015,12,24,5,2930
1415,2015,12,25,12,2942
1416,2015,12,26,5,2947
1417,2015,12,27,9,2956
1418,2015,12,28,3,2959
1419,2015,12,29,9,2968
1420,2015,12,30,6,2974
1421,2015,12,31,7,2981
1422,2016,1,1,17,17
1423,2016,1,2,9,26
1424,2016,1,3,14,40
1425,2016,1,4,6,46
1426,2016,1,5,12,58
1427,2016,1,6,9,67
1428,2016,1,7,12,79
1429,2016,1,8,18,97
1430,2016,1,9,13,110
1431,2016,1,10,11,121
1432,2016,1,11,6,127
1433,2016,1,12,11,138
1434,2016,1,13,8,146
1435,2016,1,14,6,152
1436,2016,1,15,5,157
1437,2016,1,16,19,176
1438,2016,1,17,7,183
1439,2016,1,18,4,187
1440,2016,1,19,9,196
1441,2016,1,20,4,200
1442,2016,1,21,8,208
1443,2016,1,22,8,216
1444,2016,1,23,17,233
1445,2016,1,24,1,234
1446,2016,1,25,17,251
1447,2016,1,26,4,255
1448,2016,1,27,6,261
1449,2016,1,28,6,267
1450,2016,1,29,8,275
1451,2016,1,30,11,286
1452,2016,1,31,11,297
1453,2016,2,1,6,303
1454,2016,2,2,7,310
1455,2016,2,3,2,312
1456,2016,2,4,7,319
1457,2016,2,5,5,324
1458,2016,2,6,7,331
1459,2016,2,7,12,343
1460,2016,2,8,5,348
1461,2016,2,9,3,351
1462,2016,2,10,1,352
1463,2016,2,11,8,360
1464,2016,2,12,3,363
1465,2016,2,13,7,370
1466,2016,2,14,10,380
1467,2016,2,15,4,384
1468,2016,2,16,11,395
1469,2016,2,17,4,399
1470,2016,2,18,5,404
1471,2016,2,19,6,410
1472,2016,2,20,16,426
1473,2016,2,21,12,438
1474,2016,2,22,5,443
1475,2016,2,23,6,449
1476,2016,2,24,6,455
1477,2016,2,25,3,458
1478,2016,2,26,8,466
1479,2016,2,27,13,479
1480,2016,2,28,7,486
1481,2016,2,29,3,489
1482,2016,3,1,7,496
1483,2016,3,2,12,508
1484,2016,3,3,4,512
1485,2016,3,4,8,520
1486,2016,3,5,5,525
1487,2016,3,6,5,530
1488,2016,3,7,9,539
1489,2016,3,8,18,557
1490,2016,3,9,11,568
1491,2016,3,10,4,572
1492,2016,3,11,13,585
1493,2016,3,12,12,597
1494,2016,3,13,7,604
1495,2016,3,14,12,616
1496,2016,3,15,12,628
1497,2016,3,16,9,637
1498,2016,3,17,15,652
1499,2016,3,18,16,668
1500,2016,3,19,8,676
1501,2016,3,20,11,687
1502,2016,3,21,19,706
1503,2016,3,22,12,718
1504,2016,3,23,8,726
1505,2016,3,24,4,730
1506,2016,3,25,16,746
1507,2016,3,26,13,759
1508,2016,3,27,13,772
1509,2016,3,28,8,780
1510,2016,3,29,8,788
1511,2016,3,30,15,803
1512,2016,3,31,15,818
1513,2016,4,1,8,826
1514,2016,4,2,14,840
1515,2016,4,3,13,853
1516,2016,4,4,8,861
1517,2016,4,5,7,868
1518,2016,4,6,7,875
1519,2016,4,7,15,890
1520,2016,4,8,4,894
1521,2016,4,9,3,897
1522,2016,4,10,9,906
1523,2016,4,11,7,913
1524,2016,4,12,6,919
1525,2016,4,13,11,930
1526,2016,4,14,8,938
1527,2016,4,15,8,946
1528,2016,4,16,9,955
1529,2016,4,17,19,974
1530,2016,4,18,7,981
1531,2016,4,19,16,997
1532,2016,4,20,16,1013
1533,2016,4,21,17,1030
1534,2016,4,22,4,1034
1535,2016,4,23,20,1054
1536,2016,4,24,21,1075
1537,2016,4,25,16,1091
1538,2016,4,26,8,1099
1539,2016,4,27,4,1103
1540,2016,4,28,4,1107
1541,2016,4,29,8,1115
1542,2016,4,30,14,1129
1543,2016,5,1,11,1140
1544,2016,5,2,10,1150
1545,2016,5,3,18,1168
1546,2016,5,4,5,1173
1547,2016,5,5,6,1179
1548,2016,5,6,20,1199
1549,2016,5,7,25,1224
1550,2016,5,8,15,1239
1551,2016,5,9,10,1249
1552,2016,5,10,5,1254
1553,2016,5,11,19,1273
1554,2016,5,12,6,1279
1555,2016,5,13,9,1288
1556,2016,5,14,9,1297
1557,2016,5,15,8,1305
1558,2016,5,16,11,1316
1559,2016,5,17,12,1328
1560,2016,5,18,19,1347
1561,2016,5,19,10,1357
1562,2016,5,20,13,1370
1563,2016,5,21,21,1391
1564,2016,5,22,14,1405
1565,2016,5,23,11,1416
1566,2016,5,24,8,1424
1567,2016,5,25,11,1435
1568,2016,5,26,12,1447
1569,2016,5,27,12,1459
1570,2016,5,28,30,1489
1571,2016,5,29,18,1507
1572,2016,5,30,14,1521
1573,2016,5,31,16,1537
1574,2016,6,1,12,1549
1575,2016,6,2,8,1557
1576,2016,6,3,16,1573
1577,2016,6,4,15,1588
1578,2016,6,5,11,1599
1579,2016,6,6,13,1612
1580,2016,6,7,3,1615
1581,2016,6,8,11,1626
1582,2016,6,9,14,1640
1583,2016,6,10,17,1657
1584,2016,6,11,13,1670
1585,2016,6,12,17,1687
1586,2016,6,13,25,1712
1587,2016,6,14,11,1723
1588,2016,6,15,12,1735
1589,2016,6,16,14,1749
1590,2016,6,17,13,1762
1591,2016,6,18,27,1789
1592,2016,6,19,18,1807
1593,2016,6,20,12,1819
1594,2016,6,21,9,1828
1595,2016,6,22,17,1845
1596,2016,6,23,9,1854
1597,2016,6,24,10,1864
1598,2016,6,25,28,1892
1599,2016,6,26,21,1913
1600,2016,6,27,16,1929
1601,2016,6,28,14,1943
1602,2016,6,29,17,1960
1603,2016,6,30,21,1981
1604,2016,7,1,11,1992
1605,2016,7,2,9,2001
1606,2016,7,3,14,2015
1607,2016,7,4,20,2035
1608,2016,7,5,26,2061
1609,2016,7,6,13,2074
1610,2016,7,7,6,2080
1611,2016,7,8,12,2092
1612,2016,7,9,21,2113
1613,2016,7,10,10,2123
1614,2016,7,11,13,2136
1615,2016,7,12,12,2148
1616,2016,7,13,7,2155
1617,2016,7,14,6,2161
1618,2016,7,15,10,2171
1619,2016,7,16,20,2191
1620,2016,7,17,32,2223
1621,2016,7,18,14,2237
1622,2016,7,19,11,2248
1623,2016,7,20,13,2261
1624,2016,7,21,17,2278
1625,2016,7,22,10,2288
1626,2016,7,23,18,2306
1627,2016,7,24,12,2318
1628,2016,7,25,19,2337
1629,2016,7,26,9,2346
1630,2016,7,27,7,2353
1631,2016,7,28,14,2367
1632,2016,7,29,12,2379
1633,2016,7,30,20,2399
1634,2016,7,31,23,2422
1635,2016,8,1,14,2436
1636,2016,8,2,8,2444
1637,2016,8,3,11,2455
1638,2016,8,4,10,2465
1639,2016,8,5,16,2481
1640,2016,8,6,21,2502
1641,2016,8,7,16,2518
1642,2016,8,8,22,2540
1643,2016,8,9,19,2559
1644,2016,8,10,10,2569
1645,2016,8,11,17,2586
1646,2016,8,12,11,2597
1647,2016,8,13,16,2613
1648,2016,8,14,22,2635
1649,2016,8,15,13,2648
1650,2016,8,16,13,2661
1651,2016,8,17,9,2670
1652,2016,8,18,10,2680
1653,2016,8,19,10,2690
1654,2016,8,20,20,2710
1655,2016,8,21,29,2739
1656,2016,8,22,6,2745
1657,2016,8,23,16,2761
1658,2016,8,24,12,2773
1659,2016,8,25,12,2785
1660,2016,8,26,13,2798
1661,2016,8,27,23,2821
1662,2016,8,28,32,2853
1663,2016,8,29,14,2867
1664,2016,8,30,15,2882
1665,2016,8,31,15,2897
1666,2016,9,1,10,2907
1667,2016,9,2,9,2916
1668,2016,9,3,16,2932
1669,2016,9,4,10,2942
1670,2016,9,5,31,2973
1671,2016,9,6,12,2985
1672,2016,9,7,6,2991
1673,2016,9,8,6,2997
1674,2016,9,9,10,3007
1675,2016,9,10,14,3021
1676,2016,9,11,17,3038
1677,2016,9,12,9,3047
1678,2016,9,13,7,3054
1679,2016,9,14,3,3057
1680,2016,9,15,8,3065
1681,2016,9,16,6,3071
1682,2016,9,17,16,3087
1683,2016,9,18,21,3108
1684,2016,9,19,10,3118
1685,2016,9,20,7,3125
1686,2016,9,21,17,3142
1687,2016,9,22,10,3152
1688,2016,9,23,14,3166
1689,2016,9,24,23,3189
1690,2016,9,25,18,3207
1691,2016,9,26,11,3218
1692,2016,9,27,7,3225
1693,2016,9,28,7,3232
1694,2016,9,29,11,3243
1695,2016,9,30,9,3252
1696,2016,10,1,28,3280
1697,2016,10,2,7,3287
1698,2016,10,3,10,3297
1699,2016,10,4,6,3303
1700,2016,10,5,12,3315
1701,2016,10,6,7,3322
1702,2016,10,7,11,3333
1703,2016,10,8,14,3347
1704,2016,10,9,18,3365
1705,2016,10,10,22,3387
1706,2016,10,11,14,3401
1707,2016,10,12,10,3411
1708,2016,10,13,11,3422
1709,2016,10,14,18,3440
1710,2016,10,15,17,3457
1711,2016,10,16,17,3474
1712,2016,10,17,12,3486
1713,2016,10,18,11,3497
1714,2016,10,19,14,3511
1715,2016,10,20,9,3520
1716,2016,10,21,4,3524
1717,2016,10,22,16,3540
1718,2016,10,23,21,3561
1719,2016,10,24,12,3573
1720,2016,10,25,7,3580
1721,2016,10,26,4,3584
1722,2016,10,27,11,3595
1723,2016,10,28,18,3613
1724,2016,10,29,27,3640
1725,2016,10,30,21,3661
1726,2016,10,31,18,3679
1727,2016,11,1,18,3697
1728,2016,11,2,15,3712
1729,2016,11,3,21,3733
1730,2016,11,4,20,3753
1731,2016,11,5,24,3777
1732,2016,11,6,17,3794
1733,2016,11,7,16,3810
1734,2016,11,8,7,3817
1735,2016,11,9,14,3831
1736,2016,11,10,12,3843
1737,2016,11,11,4,3847
1738,2016,11,12,16,3863
1739,2016,11,13,19,3882
1740,2016,11,14,6,3888
1741,2016,11,15,6,3894
1742,2016,11,16,9,3903
1743,2016,11,17,11,3914
1744,2016,11,18,13,3927
1745,2016,11,19,10,3937
1746,2016,11,20,9,3946
1747,2016,11,21,8,3954
1748,2016,11,22,9,3963
1749,2016,11,23,10,3973
1750,2016,11,24,12,3985
1751,2016,11,25,9,3994
1752,2016,11,26,21,4015
1753,2016,11,27,22,4037
1754,2016,11,28,15,4052
1755,2016,11,29,13,4065
1756,2016,11,30,8,4073
1757,2016,12,1,13,4086
1758,2016,12,2,10,4096
1759,2016,12,3,15,4111
1760,2016,12,4,12,4123
1761,2016,12,5,4,4127
1762,2016,12,6,12,4139
1763,2016,12,7,8,4147
1764,2016,12,8,7,4154
1765,2016,12,9,7,4161
1766,2016,12,10,4,4165
1767,2016,12,11,6,4171
1768,2016,12,12,6,4177
1769,2016,12,13,6,4183
1770,2016,12,14,4,4187
1771,2016,12,15,4,4191
1772,2016,12,16,18,4209
1773,2016,12,17,15,4224
1774,2016,12,18,9,4233
1775,2016,12,19,5,4238
1776,2016,12,20,7,4245
1777,2016,12,21,4,4249
1778,2016,12,22,9,4258
1779,2016,12,23,13,4271
1780,2016,12,24,17,4288
1781,2016,12,25,16,4304
1782,2016,12,26,17,4321
1783,2016,12,27,5,4326
1784,2016,12,28,11,4337
1785,2016,12,29,8,4345
1786,2016,12,30,10,4355
1787,2016,12,31,13,4368
1788,2017,1,1,29,29
1789,2017,1,2,10,39
1790,2017,1,3,15,54
1791,2017,1,4,2,56
1792,2017,1,5,3,59
1793,2017,1,6,6,65
1794,2017,1,7,4,69
1795,2017,1,8,3,72
1796,2017,1,9,7,79
1797,2017,1,10,5,84
1798,2017,1,11,15,99
1799,2017,1,12,4,103
1800,2017,1,13,6,109
1801,2017,1,14,12,121
1802,2017,1,15,14,135
1803,2017,1,16,10,145
1804,2017,1,17,14,159
1805,2017,1,18,6,165
1806,2017,1,19,10,175
1807,2017,1,20,11,186
1808,2017,1,21,25,211
1809,2017,1,22,19,230
1810,2017,1,23,15,245
1811,2017,1,24,6,251
1812,2017,1,25,15,266
1813,2017,1,26,3,269
1814,2017,1,27,6,275
1815,2017,1,28,15,290
1816,2017,1,29,6,296
1817,2017,1,30,10,306
1818,2017,1,31,6,312
1819,2017,2,1,8,320
1820,2017,2,2,6,326
1821,2017,2,3,8,334
1822,2017,2,4,7,341
1823,2017,2,5,9,350
1824,2017,2,6,9,359
1825,2017,2,7,10,369
1826,2017,2,8,2,371
1827,2017,2,9,3,374
1828,2017,2,10,7,381
1829,2017,2,11,11,392
1830,2017,2,12,12,404
1831,2017,2,13,6,410
1832,2017,2,14,13,423
1833,2017,2,15,10,433
1834,2017,2,16,5,438
1835,2017,2,17,7,445
1836,2017,2,18,15,460
1837,2017,2,19,9,469
1838,2017,2,20,9,478
1839,2017,2,21,5,483
1840,2017,2,22,13,496
1841,2017,2,23,2,498
1842,2017,2,24,1,499
1843,2017,2,25,12,511
1844,2017,2,26,3,514
1845,2017,2,27,3,517
1846,2017,2,28,8,525
1847,2017,3,1,1,526
1848,2017,3,2,4,530
1849,2017,3,3,3,533
1850,2017,3,4,7,540
1851,2017,3,5,11,551
1852,2017,3,6,9,560
1853,2017,3,7,16,576
1854,2017,3,8,4,580
1855,2017,3,9,4,584
1856,2017,3,10,9,593
1857,2017,3,11,10,603
1858,2017,3,12,6,609
1859,2017,3,13,5,614
1860,2017,3,14,1,615
1861,2017,3,15,3,618
1862,2017,3,16,5,623
1863,2017,3,17,9,632
1864,2017,3,18,8,640
1865,2017,3,19,6,646
1866,2017,3,20,6,652
1867,2017,3,21,2,654
1868,2017,3,22,5,659
1869,2017,3,23,7,666
1870,2017,3,24,13,679
1871,2017,3,25,8,687
1872,2017,3,26,12,699
1873,2017,3,27,7,706
1874,2017,3,28,4,710
1875,2017,3,29,7,717
1876,2017,3,30,16,733
1877,2017,3,31,2,735
1878,2017,4,1,9,744
1879,2017,4,2,14,758
1880,2017,4,3,4,762
1881,2017,4,4,11,773
1882,2017,4,5,10,783
1883,2017,4,6,7,790
1884,2017,4,7,9,799
1885,2017,4,8,11,810
1886,2017,4,9,16,826
1887,2017,4,10,15,841
1888,2017,4,11,15,856
1889,2017,4,12,9,865
1890,2017,4,13,7,872
1891,2017,4,14,8,880
1892,2017,4,15,21,901
1893,2017,4,16,17,918
1894,2017,4,17,11,929
1895,2017,4,18,15,944
1896,2017,4,19,4,948
1897,2017,4,20,5,953
1898,2017,4,21,10,963
1899,2017,4,22,17,980
1900,2017,4,23,14,994
1901,2017,4,24,15,1009
1902,2017,4,25,7,1016
1903,2017,4,26,8,1024
1904,2017,4,27,6,1030
1905,2017,4,28,8,1038
1906,2017,4,29,2,1040
1907,2017,4,30,14,1054
1908,2017,5,1,5,1059
1909,2017,5,2,8,1067
1910,2017,5,3,6,1073
1911,2017,5,4,2,1075
1912,2017,5,5,5,1080
1913,2017,5,6,7,1087
1914,2017,5,7,24,1111
1915,2017,5,8,3,1114
1916,2017,5,9,10,1124
1917,2017,5,10,5,1129
1918,2017,5,11,16,1145
1919,2017,5,12,10,1155
1920,2017,5,13,8,1163
1921,2017,5,14,11,1174
1922,2017,5,15,14,1188
1923,2017,5,16,17,1205
1924,2017,5,17,17,1222
1925,2017,5,18,11,1233
1926,2017,5,19,10,1243
1927,2017,5,20,16,1259
1928,2017,5,21,20,1279
1929,2017,5,22,7,1286
1930,2017,5,23,3,1289
1931,2017,5,24,9,1298
1932,2017,5,25,7,1305
1933,2017,5,26,6,1311
1934,2017,5,27,8,1319
1935,2017,5,28,15,1334
1936,2017,5,29,23,1357
1937,2017,5,30,15,1372
1938,2017,5,31,8,1380
1939,2017,6,1,10,1390
1940,2017,6,2,17,1407
1941,2017,6,3,11,1418
1942,2017,6,4,17,1435
1943,2017,6,5,6,1441
1944,2017,6,6,11,1452
1945,2017,6,7,12,1464
1946,2017,6,8,14,1478
1947,2017,6,9,4,1482
1948,2017,6,10,8,1490
1949,2017,6,11,33,1523
1950,2017,6,12,12,1535
1951,2017,6,13,8,1543
1952,2017,6,14,5,1548
1953,2017,6,15,12,1560
1954,2017,6,16,20,1580
1955,2017,6,17,22,1602
1956,2017,6,18,21,1623
1957,2017,6,19,11,1634
1958,2017,6,20,8,1642
1959,2017,6,21,3,1645
